200 10
                                                                                                                                                                                                        |
                                                         1 1                                                                                                                                            |
      x                                                1     1                                                                                                 1 1 1 1 1 1 1 1 1                        |
                                         Q--Q--Q--Q--1         1                                                                               1 1 1 1 1 1 1 1                   1 1 1 1 1              |
 O---------         22222              2 2 2 2 2 2 2             2 2 2 2 2 2 2 2 2                                               2 2 2 2 2 2 2                                             2 2 2 2 2    |
                1111     1 1 1 1 1 1 1       Q--Q--Q--Q--                          1 1 1 1 1                       1 1 1 1 1 1 1                                                                        |
                  O---------                             -x-                                 4 4 4 4 4 4 4 4 4 4 4                                                                                      |
                                                         ---                                                                                                                                            |
O---------O---------O---------O---------O---------O---------O---------O---------O---------P-P-P-P-P-O---------P-P-O---------P-P-O---------P-P-O---------P-P-O---------O---------O---------O---------P-P-|
--------------------------------------------------------------------------------------------------------------------------------------------------------------------------------------------------------|
                                                                                                                                                                                                        |
                                                         1 1                                                                                                                                            |
                                                       1     1                                                                                                 4 4 4 4 4 4 4 4 4                        |
                                                     1         1                                                                               1 1 1 1 1 1 1 1                   1 1 1 1 1              |
                    33333              2 2 2 3 3 3 3             3 3 3 3 3 3 3 3 3                                               3 3 3 3 3 3 3                                             3 3 3 3 3    |
                1111     1 1 1 1 1 1 1                    -                        1 1 1 1 1                       1 1 1 1 1 1 1                                                                        |
                                                         -x-                                 1 1 1 1 1 1 1 1 1 1 1                                                                                      |
                                                         ---                                                                                                                                            |
O---------O---------O---------O---------O---------O---------O---------O---------O---------P-P-P-P-P-O---------P-P-O---------P-P-O---------P-P-O---------P-P-O---------O---------O---------O---------P-P-|
--------------------------------------------------------------------------------------------------------------------------------------------------------------------------------------------------------|
                                                                                                                                                                                                        |
                                                         1 1                                                                                                                                            |
                                                       1     1                                                                                                 1 1 1 1 1 1 1 1 1                        |
                                                     1         1                                                                               1 1 1 1 1 1 1 1                   1 1 1 1 1              |
                    11111              1 1 1 1 1 1 1             1 1 1 1 1 1 1 1 1                                               1 1 1 1 1 1 1                                             1 1 1 1 1    |
                1111     1 1 1 1 1 1 1                    -                        1 1 1 1 1                       1 1 1 1 1 1 1                                                                        |
                                                         -x-                                 1 1 1 1 1 1 1 1 1 1 1                                                                                      |
                                                         ---                                                                                                                                            |
O---------O---------O---------O---------O---------O---------O---------O---------O---------P-P-P-P-P-O---------P-P-O---------P-P-O---------P-P-O---------P-P-O---------O---------O---------O---------P-P-|
--------------------------------------------------------------------------------------------------------------------------------------------------------------------------------------------------------|
